R  1080 720
NO ./map/textures/brick.xpm
SO ./map/textures/blue.xpm
WE ./map/textures/wood.xpm
EA ./map/textures/grey.xpm
S ./map/textures/chest.xpm
F 224,172,105
C 205,249,255
11111111111111111111111111
1N010000010011001000001001
10001020000011001000001001
10010002010011001000000001
10001000000011001000000001
10000001000011001000001001
10010000010000001000001001
10000001000011001000001001
10010000012211001000001001
10010000010011001000001001
10001000000011001000001001
10000001000011000000001001
10220000000000000000000001
11111111111111111111111111
